AALBA	101	5
DALALLBALBA	quip	11
LDCAARRRDDARRUA	PPCG	15
LLLLUCALLUCALLUBALLLLBA	Mego	23
LLDARRRRBARRDARRDBBCA	Mego	21
RRRRRUCALCAYRRRRARRRRDBBBAA	Noob 5	27
LLDAAYRRRRAUBBARBBBCA	Noob 5	21
LDALLALBALDDBALUARDBBALLLUUBBBBBA	penguin	33
RRDARRDARDBABARUUBARARRBBBBBA	penguin	29
LLLALALBALBALLALLLALARDDBBBBA	867-5309	29
LDDAUUALALBBBALALBALBBALLA	867-5309	26
RADDARUCALLLBALABCALDBALDALUUBCALLUCARRRRUBBBBBBBABBBBBBABA	2_sPoOkY_4_mE	59
LLDACARBBARRUBCADDALLLLDBABBBBAALARUBBBALLUCALLUBCALDBBCA	2_sPoOkY_4_mE	57
RRRRDCACAAARBADBBBAYYRRRRUCARBBBBACABAUBARRUBBBBBALLLLLBBBABBBBABAABBBBBBBA	The Nineteenth Byte	77
RRDAAAAARRRBALBBBABBABADDBBCARBBBBBBACAUBBBALUBCAYLLLDBCALLDDBBBBBAUBAY	The Nineteenth Byte	74
RRRRDCACAAARBALDDBCARBBBACABAUBBBBALLLUAYLLLDBALLLLLBABAARRRDBBAYRRDBBBA	The Nineteenth Byte	72
LDALAAADBARDALBBBBALLLBAALUBARRUARALBBBALLARDALBBBBALUBALLLLBBBBBCARRDBBBBBABBCARUBBBBBBABBBBBBBBBBBBBBBA	penguins@SouthPole.org	105
LLDAAADBARDALBBBBARUUBALLALBABBBALLARDARRRRUCARRDBBBBBABBCARUBBBARRDARDBABBBALUBBBBBBBBBBBBALUBALBBBA	penguins@SouthPole.org	101
LLLAUAAUAYLUBAUALBBBARRDCARBBBBCARDARDCARUBBCADBADBALUARRRDBCALLDBBBCALLLUUBBCARRRRRDDBBBBBBBBBBBBBBBA	8xM3R__5ltZgrkJ.-W b	102
LLLLUCAUAYUBBALBCAUARRUCARRBBBBBARCAUBALLBBALUBBALLLLDBAUBBBBAARUBALBBALLLBALUARDDBBBBBBA	8xM3R__5ltZgrkJ.-W b	90
UCALCAUAYRDBCARRBBBBARCAUBALLBBALUBALLLLDBALUBCARBBCAARUBALBBALCALLBBCALUARDDBBBBBBA	8xM3R__5ltZgrkJ.-W b	84
RDCAYUBBALCAUALBBBALBALCADBBBBARCAADBBBARRRRUARDBARDCARUBBCADBADBALUARDDBBBBBBA	8xM3R__5ltZgrkJ.-W b	80
RRUAALUAALBABALUALDAUBBBBBBBABALLLLBARDALDBBAUUBAARALBALBBBBBBBBBBBBAALARBBBBALBABBBBARALBBBBBBA	correcthorsebatterystaple	96
RRRUALABCAUCALBALBBBABCALUALBBBABCADBALLLUBALLBALBARBBBBCADBALLBBABBBBBALBBBCALUALBBBALLBBBBBBBBBBCALDDABBBCALUARDBBBBBBBBBBBABA	verylongRUNSOFCAPSandnocaps	128
LLDDAUAARABBCALBALLBALDDABBCALUALUCADBBBALDALLUABCABARBARBBBBADBARRRBBBABALLLLUBBBBBBBBBCABBBBBARUBBBBBBBBBBBBBBCARARRALLDDBBBA	verylongRUNSOFCAPSandnocaps	127
RRRRDDALCAUBABBCALBARDDBARRBBAUUBARRRADBAUBBBBCARBACALBARRDBABARBARBBBBADBABBBBBCALLUARBBBBABBBBBARRRRDBCABABBBBBBBBBBBCARUUBA	verylongRUNSOFCAPSandnocaps	126
RRRRRUCABCABAALLLALUARBBBALBBCAALBALUALBBABBBBCADBALLLUBALLBALBARDDBARUBBBBBBALUCARRRALLLDBBBALDALLUBBBCABBBBALUALBBBA	verylongRUNSOFCAPSandnocaps	118
RDDCAACALBAALUABBBBCALBABBCADBALLLUBALLBALBARDDBARRBBBBBACALUBCALUCARRRALLLDBBBALDALLUARRBBBCADARRRBBABARRRUUA	verylongRUNSOFCAPSandnocaps	110
RRRRDCACAYYYYRRDABAADDBALLLBALUBBBBBBBARRBBARBBBABABBBBABARUBBBBCARRDCARDBBBABBABBBBBBABBAUBBBBBBBBBBBBBBBBBBBARRUABBABBBBBBBBBALLDBA	This is an English sentence.	134
RDDAAAARUAAADDBALLLBAYYYYDDBBBALLBALLLLBARDBBABABBBBBBABALUUBBALLBBBBBBBBBCARRBBBBBBBBARDCARRUABBABBBBBBBBBALLDBA	This is an English sentence.	123
RRRRRUAAAALLLALLLALUBBBBAYYDDAYYRRDABABBARRBBBBADBBBBBALLUBBCARRBBBBBBARDCARRUABARRRRDBBABBABBBBBBBBABARRRRBBARRUBBA	This is an English sentence.	122
RRRRDABCALLACABAADDBALLLBALUBBBBBBALUBBAABBALLLDBBARDBBABABBBBABBAUBBBBBBBBBBBBBAYDDBARBBBABBAYYRDDBBBBBAAYRRRRRDDBA	This is an English sentence.	120
DDALLARDARRRBAUUBAABARRBBBADBBBARDBAALLLUUBCARRBBBARDCARRUAAYRDDBABBAYYRDDBBBBAAYLLLDBBALLDBADBBBABBA	This is an English sentence.	105
RDCADADAYDALBCADBALUALLBBBCADDBCABBBAUBBBBBBBBBARBARRRBAADBBALBARBBBARDBALLALARBBAUBARRRUUBARDDBBBBBBCARUBBARRRUARRBBBALLLLDDBBBBBBBBBALUUCA	WNtza.akjzSP2GI0V9X .0epmUQ-mo	141
LAADADALUAUBBBBAYUBBBAAUBAALDBALLUBALALLBCALDBALLBALLBCALLLBBABAUUBBCARRRRARRBBBBCALUBBBBBBBBBADDBCALLUALLBBARRRRBBBBBBBBBBBBARRRCARDDBCA	WNtza.akjzSP2GI0V9X .0epmUQ-mo	137
LDCAALBCALAYUBAAYYYLLDBABADBBBBBARRRARBABBARBBARBBCARRRRBCARRRRDBBBBBBCAUUBBBBBCABBBBBBBARRRRBBBBBBBBBBBBADDBBBBAALBALUBBBBALUBBABBALLLDARRRRBBBBARDBBBBBBBBBALLLLLUBA	Programming Puzzles and Code Golf	166
LLDAAALBBAYUAAYYYRRUBBCAUBBCAUBBALDALLLBBALLUBBBADDBBBAALBALUBBBBALUBBABBALLLDALUBBBBBCABBBBBBBBBBALLLLLDBBCARDBBBBBBBBBALLLLLUBARRBBBBBAUARDBBARBBCARRRRBCA	Programming Puzzles and Code Golf	157
RRRRDDAAYUAAYYYRRUBCAUBBCABBARBARBCALLUBBBBBBBCALDALLLBBALLUBBBARBBBARBBARBCARRRRCABBALLLDALLLLDAALBARRRRUUBBCARDBBBBBBBCARRRRRDARRRUUBBBABBBADARRRRUBBBBA	Programming Puzzles and Code Golf	154
RRDAADBAARBARBCABBBBBCAAYUAAYYYRRUBBBCALUBBBBCALLLBBALLUBBBARBBBARBBARBCARRRRCABBALLLDALLLLDAALBARRRRUUBBCARDBBBBBBBCARRRRRDARRRUUBBBABBBBADA	Programming Puzzles and Code Golf	145
LDCAALDCAALLLLLALBBAARRCALLDBBAUUBBCALDALDBBBAAUBBBAYLLLDBALLDDARBBAALLUBBBALUBARRRRRALLLLLBARDBBBBBARRUBBAYDDARRRRRDAYLLDBAYRRDBALLLLBBA	Programming Puzzles and Code Golf	144
LDCAALBCALALBARRAADBBABBALLLLLALBBBBABARRCALLDBBBAUUBBCALDALDBBBAAUBBBBBAYLLLLUBBAALBALUBBBBBALUBBABBARDBBBBBARDBBBBBBBBAYDDAYRRDBBBAY	Programming Puzzles and Code Golf	138
